WWWWWWWWWWWWWWW
WFFFFFFFFFFFFFW
WLFFFFFFFFFFFFW
WFFFFFFFFFFFFFW
WFFFFFFFFFFFFFW
WFFFFFFFFFFFFLW
WFFFFFFFFFFFFFW
WWWWWWWDWWWWWWW
WFFFFFFFFFWFFFW
WLFFFFFFFFWFFFW
WFFFFFFFFFDFFFW
WFFFFFFFFFWGFFW
WFFFFFFFFFWFFLW
WFFFFFFFFFWFFFW
WWWWWWWWWWWWWWW