BBBBBBBBBBBBBBB,,,,,,,,,,,,,,
B.............B,,,,,,,,,,,,,,
BL............B,,,,,,,,,,,,,,
B.............B,,,,,,,,,,,,,,
B.............B,,,,,,,,,,,,,,
B............LB,,,,,,,,,,,,,,
B.............B,,,,,,,,,,,,,,
BBBBBBBbBBBBBBBBBBBBBBBBBBBBB
BBBBBBBbBBBBBBB.............B
BL............B.............B
B.............b.......L.....B
B......G......B.............B
B.............B.............B
B.............B.............B
BBBBBBBBBBBBBBBBBBBBBBBBBBBBB