BBBBBBBBBBBBBBB,,,,,,,,,,,,,,
B.............B,,,,,,,,,,,,,,
BL............B,,,,,,,,,,,,,,
B....G........B,,,,,,,,,,,,,,
B.............B,,,,,,,,,,,,,,
B............LB,,,,,,,,,,,,,,
B.............B,,,,,,,,,,,,,,
BBBBBBBbBBBBBBBIIIIIIIIIIIIII
IIIIIIIiIIIIIII.............I
IL...........SI.............I
I.............i.......L.....I
I............SI.............I
I.............I.............I
I.............I.............I
IIIIIIIIIIIIIIIIIIIIIIIIIIIII