BBBBBBBBBBBBBBBIIIIIIIIIIIIII
B.............BI.....L......I
BL............BIIIIII.IIIIIII
B.............B,,,,,I.I,,,,,,
B.............B,,,,,I.I,,,,,,
B............LB,,,,,I.I,,,,,,
B.............B,,,,,I.I,,,,,,
BBBBBBBbBBBBBBBBBBBBB.BBBBBBB
BBBBBBBbBBBBBBB.............B
BL............B.............B
B.............b.......L.....B
B......G......B.............B
B.............B.............B
B.............B.............B
BBBBBBBBBBBBBBBBBBBBBBBBBBBBB